111111111
1C0C00001
100000001
100p00001
100000001
1P0000001
10000E001
100000001
111111111
